cent	CHIF_CENT
cents	CHIF_CENT
cinq	CHIF
cinquante	CHIF_DIZAINE
cinquième		CHIF_RANK
cinquièmes	CHIF_RANK
deux	CHIF
deuxième	CHIF_RANK
deuxièmes	CHIF_RANK
dix	CHIF_DIX
douze	CHIF_NAT
douzième	CHIF_RANK
douzièmes	CHIF_RANK
huit	CHIF
huitième	CHIF_RANK
huitièmes	CHIF_RANK
mille	CHIF_MILLE
milliard	CHIF_MILLIARD
milliards	CHIF_MILLIARD
million	CHIF_MILLION
millions	CHIF_MILLION
neuf	CHIF
neuvième	CHIF_RANK
neuvièmes	CHIF_RANK
nonante	CHIF_DIZAINE
octante	CHIF_DIZAINE
onze	CHIF_NAT
onzième	CHIF_RANK
onzièmes	CHIF_RANK
quarante	CHIF_DIZAINE
quatorze	CHIF_NAT
quatorzième	CHIF_RANK
quatorzièmes	CHIF_RANK
quatre	CHIF
quatre_vingt	CHIF_DIZAINE
quatre_vingts	CHIF_DIZAINE
quatrième	CHIF_RANK
quatrièmes	CHIF_RANK
quinze	CHIF_NAT
quinzième	CHIF_RANK
quinzièmes	CHIF_RANK
seize	CHIF_NAT
seizième	CHIF_RANK
seizièmes	CHIF_RANK
sept	CHIF
septante	CHIF_DIZAINE
septième	CHIF_RANK
septièmes	CHIF_RANK
six	CHIF
sixième	CHIF_RANK
sixièmes	CHIF_RANK
soixante	CHIF_DIZAINE
soixantième	CHIF_RANK
soixantièmes	CHIF_RANK
treize	CHIF_NAT
treizième	CHIF_RANK
treizièmes	CHIF_RANK
trente	CHIF_DIZAINE
trentième	CHIF_RANK
trentièmes	CHIF_RANK
trois	CHIF
troisième	CHIF_RANK
troisièmes	CHIF_RANK
vingt	CHIF_DIZAINE
vingtième	CHIF_RANK
vingtièmes	CHIF_RANK
lundi	DAY
mardi	DAY
mercredi	DAY
jeudi	DAY
vendredi	DAY
samedi	DAY
dimanche	DAY
Lundi	DAY
Mardi	DAY
Mercredi	DAY
Jeudi	DAY
Vendredi	DAY
Samedi	DAY
Dimanche	DAY
janvier	MONTH
février	MONTH
mars	MONTH
avril	MONTH
mai	MONTH
juin	MONTH
juillet	MONTH
août	MONTH
septembre	MONTH
octobre	MONTH
novembre	MONTH
décembre	MONTH
Janvier	MONTH
Février	MONTH
Mars	MONTH
Avril	MONTH
Mai	MONTH
Juin	MONTH
Juillet	MONTH
Août	MONTH
Septembre	MONTH
Octobre	MONTH
Novembre	MONTH
Décembre	MONTH
fevrier	MONTH
Fevrier	MONTH
aout	MONTH
Aout	MONTH
decembre	MONTH
Decembre	MONTH
